9 11
L L T T T C C T T T T C
L T T T T C C C T T T C
L L C C T C C T T T T C
C L T T T C C T T L L T
T L T T T L C T T C L T
T T T T T C C T T T C T
C C T C T C C T T T C T
T T T T T C C T T C C T
L L T T T C C T T L L L