8 10

LLTTTCCTTT
LTTTTCCCTT
LLCCTCCTTT
CLTTTCCTTL
TLTTTLCTTC
TTTTTCCTTT
CCTCTCCTTT
TTTTTCCTTC